###################################################################################################
#                          #                                                                      #
#                          #                                                                      #
#                          #                                                                      #
#        X                                                                                        #
#                          #                                                                      #
#                          #                                                                      #
############################                                                                      #
#                                                                                                 #
#                                                                                                 #
#                                                                                                 #
#                                                                                                 #
#                                                                                                 #
#                                                                                                 #
#                                                                                                 #
#                                                                                                 #
#                                                                                        O        #
#                                                                                                 #
#                                                                                                 #
###################################################################################################