#################
#               #
#           O   #
#     ########  #
#            #  #
#            #  #
#            #  #
#            #  #
#            #  #
#            #  #
#            #  #
#            #  #
#            #  #
#X ###########  #
#               #
#               #
#################